#################################
#       #                       #
#       #                       #
#       #                       #
#       #                       @
#       #############           #
#       #       #               #
#       #                       #
#                    ~          #
#                               #
#                               #
#                               #
#                               #
#              #                #
##             #                #
#                               #
#                               #
#                               #
#                               #
#                               #
#                               #
#       #                       #
#                               #
#                               #
#                               #
#            #                  #
#             #                 #
#                               #
#                               #
#                               #
#                               #
#                    #          #
################~~#############~#