#################################
#                               #
#                               #
#                               #
#                               #
#                               #
#                               #
#                               #
#                               #
#                               #
#                               #
#                               #
#                               #
#                               #
#                               #
~                               #
#                      ~~~~~~~~~#
~                               #
#                               #
#                               #
#                               #
#                               #
#          #                    #
#          #                    #
#          #                    #
#          #                    #
#          ####                 #
#          #  #                 #
#          #  #                 #
#          #  #                 #
#          #                    #
#################################