####~####
#       #
# #     #
# #     #
###     ~
#       #
#       #
#     # #
#######@#