####@####
#       #
#       #
#       #
#       #
#       #
#       #
#    #  #
#########