####~####
# #   # #
#### ####
# ## ## #
###     #
#       $
# ## ## #
#    ## #
#######~#